NO textures/north_texture.png
SO textures/south_texture.png  
WE textures/west_texture.png
EA textures/east_texture.png

F 220,100,0
C 225,30,0

1111111101111111111111111
10S0110000100000000000001
1000110000000000111111001
1000110001100000110001001
1000000000100000000001001
1111111111111111111111111
