NO ./test_north.xpm42
SO ./test_south.xpm42
WE ./test_west.xpm42
EA ./test_east.xpm42
F 220,100,0
C 225,30,0

1111111111111111111111111
0000000000110000000000001
1011000001110000000000001
1001000000000000000000001
1111111111110111111111111
1000000000000000000000001
1111011111110111111111111
1111011111110111111111111
1000000000110101111111111
1000000000000000000000001
1000000000N00000000000001
1111111111111111111111111
